Zac Bierk,/players/b/bierkza01.html,G,1,47,0,1,1,6.2,9,0,0,0,0
Ilya Bryzgalov,/players/b/bryzgil01.html,G,12,465,0,12,12,81.3,221,0,0,0,7
John Curry,/players/c/curryjo01.html,G,4,8,0,0,0,0.4,3,0,0,0,1
Wade Dubielewicz,/players/d/dubiewa01.html,G,3,43,0,0,0,7.8,18,0,0,0,1
Derek Gustafson,/players/g/gustade01.html,G,5,5,0,0,0,0.6,1,0,0,0,1
Matt Hackett,/players/h/hackema01.html,G,13,26,0,0,0,3.6,4,0,0,0,3
Josh Harding,/players/h/hardijo01.html,G,151,151,0,2,2,27.3,60,0,2,2,60
Anton Khudobin,/players/k/khudoan01.html,G,6,188,0,3,3,33.0,83,0,0,0,4
Dieter Kochan,/players/k/kochadi01.html,G,1,21,0,0,0,0.5,1,0,0,0,0
Darcy Kuemper,/players/k/kuempda01.html,G,102,186,0,4,4,31.5,80,0,1,1,41
Jamie McLennan,/players/m/mclenja01.html,G,38,254,0,3,3,31.5,80,0,1,1,5
Dwayne Roloson,/players/r/rolosdw01.html,G,167,606,0,14,14,102.0,227,0,2,2,62
Alex Stalock,/players/s/staloal01.html,G,51,113,0,3,3,15.0,41,0,2,2,17
Jose Theodore,/players/t/theodjo01.html,G,32,648,1,16,17,111.0,286,0,0,0,15
Pontus Aberg,/players/a/abergpo01.html,LW,22,127,17,26,43,3.2,0,1,5,6,0
Cody Almond,/players/a/almonco01.html,C,25,25,2,0,2,-0.2,0,2,0,2,0
Chris Armstrong,/players/a/armstch01.html,D,3,7,0,1,1,0.0,0,0,0,0,0
Drew Bagnall,/players/b/bagnadr01.html,D,2,2,0,0,0,-0.1,0,0,0,0,0
Keith Ballard,/players/b/ballake01.html,D,59,604,38,137,175,33.0,0,2,8,10,0
Cam Barker,/players/b/barkeca01.html,D,71,310,21,75,96,15.1,0,2,10,12,0
Matt Bartkowski,/players/b/bartkma01.html,D,2,255,8,40,48,9.2,0,1,0,1,0
Peter Bartos,/players/b/bartope01.html,LW,13,13,4,2,6,0.9,0,4,2,6,0
Shawn Belle,/players/b/bellesh01.html,D,9,20,0,1,1,0.5,0,0,1,1,0
Louie Belpedio,/players/b/belpelo01.html,D,3,3,0,2,2,0.3,0,0,2,2,0
Ladislav Benysek,/players/b/benysla01.html,D,159,161,3,12,15,4.0,0,3,12,15,0
Sean Bergenheim,/players/b/bergese01.html,LW,17,506,96,84,180,16.6,0,1,0,1,0
Marc-Andre Bergeron,/players/b/bergema02.html,D,72,490,82,153,235,42.6,0,14,18,32,0
Christoph Bertschy,/players/b/bertsch02.html,C,9,9,0,1,1,0.0,0,0,1,1,0
Stu Bickel,/players/b/bickest01.html,D,9,76,0,10,10,1.9,0,0,1,1,0
Anthony Bitetto,/players/b/bitetan01.html,D,18,132,2,17,19,3.0,0,0,0,0,0
Sylvain Blouin,/players/b/blouisy01.html,LW,86,115,3,4,7,-1.0,0,3,4,7,0
Jonathon Blum,/players/b/blumjo02.html,D,19,110,7,17,24,4.3,0,0,2,2,0
Brian Bonin,/players/b/boninbr01.html,C,7,12,0,0,0,-0.4,0,0,0,0,0
Sebastien Bordeleau,/players/b/bordese01.html,C,14,251,37,61,98,6.4,0,1,4,5,0
Christoph Brandner,/players/b/brandch01.html,LW,35,35,4,5,9,0.7,0,4,5,9,0
Brad Brown,/players/b/brownbr01.html,D,138,330,2,27,29,6.0,0,0,6,6,0
J.T. Brown,/players/b/brownjt01.html,RW,56,365,23,49,72,3.3,0,3,5,8,0
Brett Bulmer,/players/b/bulmebr01.html,RW,17,17,0,3,3,0.0,0,0,3,3,0
Patrick Cannone,/players/c/cannopa01.html,C,3,3,0,0,0,0.0,0,0,0,0,0
Keith Carney,/players/c/carneke01.html,D,141,1018,45,183,228,66.8,0,5,23,28,0
Ryan Carter,/players/c/cartery01.html,LW,113,473,41,52,93,6.1,0,10,15,25,0
Eric Chouinard,/players/c/chouier01.html,LW,31,90,11,11,22,1.8,0,3,4,7,0
Marc Chouinard,/players/c/chouima01.html,C,119,320,37,41,78,6.2,0,25,26,51,0
Erik Christensen,/players/c/chriser01.html,C,29,387,68,95,163,14.7,0,6,1,7,0
Brett Clark,/players/c/clarkbr01.html,D,8,689,45,141,186,31.7,0,0,1,1,0
Matt Cooke,/players/c/cookema01.html,C,111,1046,167,231,398,36.9,0,14,24,38,0
David Cullen,/players/c/culleda01.html,D,3,19,0,0,0,-0.4,0,0,0,0,0
Tyler Cuma,/players/c/cumaty01.html,D,1,1,0,0,0,0.0,0,0,0,0,0
Alexandre Daigle,/players/d/daiglal02.html,C,124,616,129,198,327,25.8,0,25,54,79,0
J.J. Daigneault,/players/d/daignjj01.html,D,1,899,53,197,250,48.9,0,0,0,0,0
Zac Dalpe,/players/d/dalpeza01.html,RW,11,141,12,13,25,0.9,0,2,2,4,0
Pavol Demitra,/players/d/demitpa01.html,LW,139,847,304,464,768,90.0,0,40,78,118,0
Jon DiSalvatore,/players/d/disaljo01.html,RW,1,6,0,0,0,-0.1,0,0,0,0,0
Hnat Domenichelli,/players/d/domenhn01.html,LW,28,267,52,61,113,8.6,0,1,5,6,0
Ryan Donato,/players/d/donatry01.html,C,22,68,15,19,34,3.0,0,4,12,16,0
Jake Dowell,/players/d/dowelja01.html,C,3,157,11,22,33,2.0,0,0,0,0,0
Robbie Earl,/players/e/earlro01.html,LW,38,47,6,1,7,0.5,0,6,0,6,0
Andrew Ebbett,/players/e/ebbetan01.html,C,49,224,26,45,71,5.8,0,8,6,14,0
Tyler Ennis,/players/e/ennisty01.html,C,73,543,117,159,276,26.6,0,8,14,22,0
Joel Eriksson Ek,/players/e/eriksjo02.html,C,148,148,16,21,37,2.2,0,16,21,37,0
Justin Falk,/players/f/falkju01.html,D,121,279,3,30,33,4.2,0,1,14,15,0
Todd Fedoruk,/players/f/fedorto01.html,LW,58,545,32,65,97,4.7,0,6,5,11,0
Eric Fehr,/players/f/fehrer01.html,RW,72,652,113,108,221,23.9,0,7,8,15,0
Scott Ferguson,/players/f/fergusc01.html,D,15,218,7,14,21,6.9,0,0,0,0,0
Landon Ferraro,/players/f/ferrala01.html,C,2,77,7,5,12,0.3,0,1,0,1,0
Kevin Fiala,/players/f/fialake01.html,LW,19,223,48,56,104,10.2,0,3,4,7,0
Marcus Foligno,/players/f/foligma01.html,LW,159,506,64,94,158,13.2,0,15,27,42,0
Christian Folin,/players/f/folinch01.html,D,118,228,7,35,42,10.2,0,4,19,23,0
Kurtis Foster,/players/f/fosteku01.html,D,195,405,42,118,160,27.9,0,21,55,76,0
Kris Foucault,/players/f/foucakr01.html,LW,1,1,0,0,0,0.0,0,0,0,0,0
Matt Foy,/players/f/foyma01.html,RW,56,56,6,7,13,1.0,0,6,7,13,0
Kris Fredheim,/players/f/fredhkr01.html,D,3,3,0,0,0,-0.1,0,0,0,0,0
Dan Fritsche,/players/f/fritsda01.html,C,34,256,34,42,76,6.1,0,4,5,9,0
Kurtis Gabriel,/players/g/gabriku01.html,RW,16,38,2,3,5,0.4,0,0,1,1,0
Aaron Gavey,/players/g/gaveyaa01.html,C,146,360,41,50,91,4.0,0,16,25,41,0
Chay Genoway,/players/g/genowch01.html,D,1,1,0,1,1,0.1,0,0,1,1,0
Tom Gilbert,/players/g/gilbeto01.html,D,63,655,45,178,223,40.0,0,3,15,18,0
Colton Gillies,/players/g/gillico01.html,LW,89,154,6,12,18,-0.1,0,3,7,10,0
Tyler Graovac,/players/g/graovty01.html,C,57,62,7,2,9,0.8,0,7,2,9,0
Jordan Greenway,/players/g/greenjo02.html,LW,87,87,12,13,25,1.6,0,12,13,25,0
Adam Hall,/players/h/hallad01.html,RW,23,682,69,87,156,5.3,0,2,3,5,0
Martin Hanzal,/players/h/hanzama01.html,C,20,673,127,211,338,29.2,0,4,9,13,0
Martin Havlat,/players/h/havlama01.html,RW,151,790,242,352,594,70.6,0,40,76,116,0
Dany Heatley,/players/h/heatlda01.html,LW,194,869,372,419,791,95.2,0,47,55,102,0
Matt Hendricks,/players/h/hendrma01.html,C,22,607,54,62,116,5.2,0,0,2,2,0
Darby Hendrickson,/players/h/hendrda01.html,C,182,518,65,64,129,3.3,0,29,31,60,0
Alex Henry,/players/h/henryal01.html,D,134,177,2,9,11,0.6,0,2,9,11,0
Andy Hilbert,/players/h/hilbean01.html,C/LW,4,307,42,62,104,8.4,0,0,0,0,0
Sean Hill,/players/h/hillse01.html,D,35,876,62,236,298,57.2,0,2,7,9,0
Shane Hnidy,/players/h/hnidysh01.html,D,70,550,16,55,71,16.7,0,2,12,14,0
Brad Hunt,/players/h/huntbr01.html,D,29,120,10,29,39,5.6,0,3,2,5,0
Danny Irmen,/players/i/irmenda01.html,C,2,2,0,0,0,-0.1,0,0,0,0,0
Nick Johnson,/players/j/johnsni01.html,RW,77,113,14,23,37,3.1,0,8,18,26,0
David Jones,/players/j/jonesda01.html,RW,16,462,104,87,191,18.9,0,2,1,3,0
Petr Kalus,/players/k/kaluspe01.html,LW,2,11,4,1,5,0.7,0,0,0,0,0
Steven Kampfer,/players/k/kampfst01.html,D,13,201,13,19,32,6.9,0,2,1,3,0
Matt Kassian,/players/k/kassima01.html,LW,28,76,4,1,5,0.2,0,2,0,2,0
Steve Kelly,/players/k/kellyst01.html,C,2,149,9,12,21,-1.1,0,0,0,0,0
Michael Ker√§nen,/players/k/keranmi01.html,F,1,1,0,0,0,-0.1,0,0,0,0,0
Justin Kloos,/players/k/kloosju01.html,C,1,2,0,0,0,0.0,0,0,0,0,0
Chuck Kobasew,/players/k/kobasch01.html,RW,105,601,110,100,210,19.7,0,18,12,30,0
Krys Kolanos,/players/k/kolankr01.html,C,21,149,20,22,42,3.6,0,3,3,6,0
Zenon Konopka,/players/k/konopze01.html,C,73,346,12,18,30,-2.6,0,1,1,2,0
Sergei Krivokrasov,/players/k/krivose01.html,RW,63,450,86,109,195,17.0,0,8,16,24,0
Luke Kunin,/players/k/kuninlu01.html,C,68,68,8,13,21,1.0,0,8,13,21,0
Johan Larsson,/players/l/larssjo02.html,LW/C,1,331,32,47,79,3.2,0,0,0,0,0
Guillaume Latendresse,/players/l/latengu01.html,LW,82,341,87,60,147,17.0,0,33,19,52,0
Jordan Leopold,/players/l/leopojo01.html,D,18,695,67,147,214,43.5,0,0,1,1,0
Curtis Leschyshyn,/players/l/leschcu01.html,D,54,1033,47,165,212,43.2,0,2,3,5,0
Mike Lundin,/players/l/lundimi01.html,D,17,252,4,32,36,8.2,0,0,2,2,0
John Madden,/players/m/maddejo01.html,C,76,898,165,183,348,30.5,0,12,13,25,0
Jason Marshall,/players/m/marshja02.html,D,137,526,16,51,67,16.9,0,7,15,22,0
Christian Matte,/players/m/mattech01.html,RW,3,25,2,3,5,0.1,0,0,0,0,0
Mike Matteucci,/players/m/mattemi01.html,D,6,6,0,0,0,0.0,0,0,0,0,0
Cody McCormick,/players/m/mccorco01.html,C/RW,14,405,21,44,65,1.8,0,1,1,2,0
David McIntyre,/players/m/mcintda01.html,C,7,7,1,1,2,0.2,0,1,1,2,0
Steve McKenna,/players/m/mckenst01.html,LW,20,373,18,14,32,-1.2,0,1,1,2,0
Carson McMillan,/players/m/mcmilca01.html,RW,16,16,2,3,5,0.6,0,2,3,5,0
Zbynek Michalek,/players/m/michazb01.html,D,22,784,42,136,178,39.8,0,1,1,2,0
Torrey Mitchell,/players/m/mitchto01.html,C,103,666,67,85,152,10.0,0,5,12,17,0
Zack Mitchell,/players/m/mitchza01.html,RW,34,34,3,2,5,0.1,0,3,2,5,0
Tomas Mojzis,/players/m/mojzito01.html,D,4,17,1,2,3,0.7,0,0,1,1,0
Dominic Moore,/players/m/mooredo01.html,C,40,897,106,176,282,19.2,0,3,2,5,0
Jason Morgan,/players/m/morgaja01.html,C,4,44,2,5,7,-0.2,0,0,0,0,0
Matt Moulson,/players/m/moulsma01.html,LW,20,650,176,193,369,42.2,0,6,7,13,0
Bill Muckalt,/players/m/muckabi01.html,RW,8,256,40,57,97,8.9,0,5,3,8,0
Curtis Murphy,/players/m/murphcu01.html,D,1,1,0,0,0,0.0,0,0,0,0,0
Ryan Murphy,/players/m/murphry01.html,D,23,175,8,35,43,7.2,0,2,3,5,0
Andrei Nazarov,/players/n/nazaran01.html,LW,2,571,53,71,124,5.0,0,0,0,0,0
Jeff Nielsen,/players/n/nielsje01.html,RW,59,252,20,27,47,1.2,0,3,8,11,0
Owen Nolan,/players/n/nolanow01.html,RW,132,1200,422,463,885,91.6,0,41,37,78,0
Maxim Noreau,/players/n/noreama01.html,D,6,6,0,0,0,0.0,0,0,0,0,0
Petteri Nummelin,/players/n/nummepe01.html,D,78,139,9,36,45,7.0,0,5,24,29,0
Kai Nurminen,/players/n/nurmika01.html,LW,2,69,17,11,28,2.6,0,1,0,1,0
Eric Nystrom,/players/n/nystrer01.html,LW,82,593,75,48,123,5.6,0,4,8,12,0
Sean O'Donnell,/players/o/odonnse01.html,D,63,1224,31,198,229,58.8,0,4,12,16,0
Cal O'Reilly,/players/o/oreilca01.html,C,1,145,16,33,49,3.4,0,0,0,0,0
Patrick O'Sullivan,/players/o/osullpa01.html,C,21,334,58,103,161,11.5,0,1,6,7,0
Gustav Olofsson,/players/o/olofsgu01.html,D,56,56,0,11,11,1.6,0,0,11,11,0
Peter Olvecky,/players/o/olvecpe01.html,C,31,32,2,5,7,0.6,0,2,5,7,0
Jed Ortmeyer,/players/o/ortmeje01.html,C,39,345,22,31,53,0.4,0,1,1,2,0
Jarod Palmer,/players/p/palmeja01.html,RW,6,6,1,0,1,0.0,0,1,0,1,0
Nick Palmieri,/players/p/palmini01.html,RW,9,87,13,12,25,2.7,0,0,0,0,0
Mark Parrish,/players/p/parrima01.html,RW,142,722,216,171,387,42.6,0,35,34,69,0
Pavel Patera,/players/p/paterpa01.html,C,20,32,2,7,9,0.1,0,1,3,4,0
Greg Pateryn,/players/p/patergr01.html,D,80,247,4,32,36,7.9,0,1,6,7,0
Scott Pellerin,/players/p/pellesc01.html,LW,58,536,72,126,198,14.3,0,11,28,39,0
Warren Peters,/players/p/peterwa01.html,C,69,96,4,4,8,-0.9,0,2,4,6,0
Chris Porter,/players/p/portech01.html,C,61,234,15,19,34,1.1,0,4,3,7,0
Benoit Pouliot,/players/p/poulibe01.html,LW,65,625,130,133,263,30.9,0,9,9,18,0
Darroll Powe,/players/p/poweda01.html,C,90,329,28,28,56,0.8,0,6,7,13,0
Teemu Pulkkinen,/players/p/pulkkte01.html,RW,9,83,13,9,22,2.6,0,1,0,1,0
Kyle Quincey,/players/q/quincky01.html,D,18,586,36,122,158,34.2,0,0,3,3,0
Branko Radivojevic,/players/r/radivbr01.html,RW,155,393,52,68,120,7.8,0,18,23,41,0
Victor Rask,/players/r/raskvi01.html,C,23,362,65,101,166,15.6,0,2,1,3,0
Chad Rau,/players/r/rauch01.html,C,9,9,2,0,2,0.3,0,2,0,2,0
Kyle Rau,/players/r/rauky01.html,C,9,42,2,3,5,-0.1,0,0,2,2,0
Matt Read,/players/r/readma01.html,RW,12,449,88,100,188,18.2,0,1,0,1,0
Mike Reilly,/players/r/reillmi01.html,D,84,160,7,30,37,5.9,0,4,14,18,0
Erik Reitz,/players/r/reitzer01.html,D,37,48,1,1,2,0.6,0,1,1,2,0
Randy Robitaille,/players/r/robitra01.html,C,67,531,84,172,256,20.7,0,12,28,40,0
Travis Roche,/players/r/rochetr01.html,D,10,60,6,14,20,3.6,0,0,1,1,0
Stacy Roest,/players/r/roestst01.html,RW,134,244,28,48,76,5.9,0,17,31,48,0
Cliff Ronning,/players/r/ronnicl01.html,C,80,1137,306,563,869,78.1,0,17,31,48,0
Mike Rupp,/players/r/ruppmi01.html,C,45,610,54,45,99,6.5,0,1,4,5,0
Jordan Schroeder,/players/s/schrojo01.html,C,88,165,18,24,42,4.0,0,11,14,25,0
John Scott,/players/s/scottjo01.html,LW,71,286,5,6,11,0.9,0,1,2,3,0
Nick Seeler,/players/s/seeleni01.html,D,93,93,2,9,11,3.4,0,2,9,11,0
Devin Setoguchi,/players/s/setogde01.html,RW,117,516,131,130,261,29.2,0,32,31,63,0
Jaime Sifers,/players/s/siferja01.html,D,14,37,0,2,2,0.3,0,0,0,0,0
Roman Simicek,/players/s/simicro01.html,C,34,63,7,10,17,1.0,0,4,4,8,0
Chris Simon,/players/s/simonch01.html,LW,10,782,144,161,305,28.6,0,0,0,0,0
Nathan Smith,/players/s/smithna02.html,C,9,26,0,0,0,-0.6,0,0,0,0,0
Wyatt Smith,/players/s/smithwy01.html,C,61,211,10,22,32,-0.2,0,3,3,6,0
Carson Soucy,/players/s/soucyca01.html,D,3,3,0,0,0,-0.1,0,0,0,0,0
Brad Staubitz,/players/s/staubbr01.html,RW,114,230,10,11,21,0.5,0,4,5,9,0
Jeremy Stevenson,/players/s/steveje01.html,LW,35,207,19,19,38,2.2,0,5,6,11,0
Cam Stewart,/players/s/stewaca01.html,LW,54,202,16,23,39,0.9,0,4,9,13,0
Chris Stewart,/players/s/stewach02.html,RW,146,652,160,161,321,35.9,0,25,20,45,0
Jarret Stoll,/players/s/stollja01.html,C,51,872,144,244,388,34.1,0,3,3,6,0
Tyson Strachan,/players/s/stracty01.html,D,2,186,1,19,20,-0.8,0,0,0,0,0
Nico Sturm,/players/s/sturmni01.html,C,2,2,0,0,0,0.0,0,0,0,0,0
Maxim Sushinsky,/players/s/sushima01.html,RW,30,30,7,4,11,1.0,0,7,4,11,0
Brett Sutter,/players/s/suttebr04.html,LW,6,60,2,8,10,0.1,0,0,3,3,0
Andy Sutton,/players/s/suttoan01.html,D,88,676,38,112,150,29.9,0,5,8,13,0
Petr Sykora,/players/s/sykorpe01.html,RW,14,1017,323,398,721,82.9,0,2,1,3,0
Jeff Taffe,/players/t/taffeje01.html,C,5,180,21,25,46,3.1,0,0,2,2,0
Daniel Tjarnqvist,/players/t/tjarnda01.html,D,60,352,18,72,90,15.9,0,3,15,18,0
Jean-Guy Trudel,/players/t/trudeje01.html,LW,1,5,0,0,0,-0.1,0,0,0,0,0
Alex Tuch,/players/t/tuchal01.html,RW,6,158,35,54,89,9.0,0,0,0,0,0
Thomas Vanek,/players/v/vanekth01.html,LW,154,1029,373,416,789,95.9,0,39,54,93,0
Tony Virta,/players/v/virtato01.html,RW,8,8,2,3,5,0.6,0,2,3,5,0
Aaron Voros,/players/v/vorosaa01.html,C,55,162,18,19,37,2.7,0,7,7,14,0
Rickard Wallin,/players/w/walliri01.html,C,19,79,8,11,19,1.0,0,6,4,10,0
Kyle Wanvig,/players/w/wanviky01.html,RW,64,75,6,9,15,0.6,0,5,9,14,0
Joel Ward,/players/w/wardjo02.html,RW,11,726,133,171,304,28.9,0,0,1,1,0
Mattias Weinhandl,/players/w/weinhma01.html,RW,27,182,19,37,56,4.6,0,3,4,7,0
Craig Weller,/players/w/wellecr01.html,RW,36,95,4,10,14,0.2,0,1,2,3,0
Casey Wellman,/players/w/wellmca01.html,C,41,54,6,10,16,1.3,0,4,9,13,0
Erik Westrum,/players/w/westrer01.html,C,10,27,1,2,3,-0.3,0,0,1,1,0
Ryan White,/players/w/whitery01.html,C,19,313,31,30,61,2.9,0,2,1,3,0
Todd White,/players/w/whiteto02.html,C,138,653,141,240,381,37.3,0,32,52,84,0
Jason Wiemer,/players/w/wiemeja01.html,C,62,726,90,112,202,10.9,0,7,11,18,0
Daniel Winnik,/players/w/winnida01.html,C/LW,81,798,82,169,251,18.1,0,6,17,23,0
Andrei Zyuzin,/players/z/zyuzian01.html,D,188,496,38,82,120,25.8,0,19,36,55,0
